{
  "cols": 26,
  "rows": 29,
  "tileSize": 32,
  "tunnelRows": [6, 19],
  "playerSpawn": { "x": 12, "y": 22 },
  "ghostSpawns": [
    { "x": 11, "y": 13 },
    { "x": 12, "y": 13 },
    { "x": 13, "y": 13 },
    { "x": 14, "y": 13 }
  ],
  "ghostPenExit": { "x": 12, "y": 11 },
  "ghostPenCenter": { "x": 12, "y": 13 },
  "eggs": [
    { "x": 0, "y": 0 },
    { "x": 25, "y": 0 },
    { "x": 0, "y": 28 },
    { "x": 25, "y": 28 }
  ],
  "grid": [
    [3,2,2,2,2,2,2,2,2,2,2,2,2,2,2,2,2,2,2,2,2,2,2,2,2,3],
    [2,0,0,2,0,0,0,0,2,0,0,0,0,0,0,0,0,2,0,0,0,0,2,0,0,2],
    [2,0,0,2,0,0,0,0,2,0,0,0,0,0,0,0,0,2,0,0,0,0,2,0,0,2],
    [2,0,0,2,2,2,0,0,2,2,2,2,0,0,2,2,2,2,0,0,2,2,2,0,0,2],
    [2,0,0,0,0,2,0,0,2,0,0,2,0,0,2,0,0,2,0,0,2,0,0,0,0,2],
    [2,0,0,0,0,2,0,0,2,0,0,2,0,0,2,0,0,2,0,0,2,0,0,0,0,2],
    [2,2,2,2,2,2,2,2,2,0,0,2,0,0,2,0,0,2,2,2,2,2,2,2,2,2],
    [0,0,2,0,0,0,0,0,2,0,0,2,2,2,2,0,0,2,0,0,0,0,0,2,0,0],
    [0,0,2,0,0,0,0,0,2,0,0,0,0,0,0,0,0,2,0,0,0,0,0,2,0,0],
    [0,0,2,2,2,2,0,0,2,0,0,0,0,0,0,0,0,2,0,0,2,2,2,2,0,0],
    [0,0,2,0,0,2,0,0,2,2,1,1,1,1,1,1,2,2,0,0,2,0,0,2,0,0],
    [0,0,2,0,0,2,0,0,2,0,0,0,1,1,0,0,0,2,0,0,2,0,0,2,0,0],
    [0,0,2,0,0,2,0,0,2,0,0,0,1,1,0,0,0,2,0,0,2,0,0,2,0,0],
    [2,2,2,0,0,2,2,2,2,0,0,1,1,1,1,0,0,2,2,2,2,0,0,2,2,2],
    [2,0,0,0,0,0,0,0,2,0,0,0,0,0,0,0,0,2,0,0,0,0,0,0,0,2],
    [2,0,0,0,0,0,0,0,2,0,0,0,0,0,0,0,0,2,0,0,0,0,0,0,0,2],
    [2,2,2,2,2,2,2,2,2,2,2,1,1,1,1,2,2,2,2,2,2,2,2,2,2,2],
    [0,0,0,2,0,0,0,0,0,0,0,2,0,0,2,0,0,0,0,0,0,0,2,0,0,0],
    [0,0,0,2,0,0,0,0,0,0,0,2,0,0,2,0,0,0,0,0,0,0,2,0,0,0],
    [2,2,2,2,0,0,2,2,2,2,2,2,0,0,2,2,2,2,2,2,0,0,2,2,2,2],
    [0,0,0,2,0,0,2,0,0,2,0,0,0,0,0,0,2,0,0,2,0,0,2,0,0,0],
    [0,0,0,2,0,0,2,0,0,2,0,0,0,0,0,0,2,0,0,2,0,0,2,0,0,0],
    [0,0,0,2,2,2,2,0,0,2,2,2,2,2,2,2,2,0,0,2,2,2,2,0,0,0],
    [0,0,0,2,0,0,2,0,0,0,0,2,0,0,2,0,0,0,0,2,0,0,2,0,0,0],
    [0,0,0,2,0,0,2,0,0,0,0,2,0,0,2,0,0,0,0,2,0,0,2,0,0,0],
    [2,2,2,2,0,0,2,0,0,2,2,2,0,0,2,2,2,0,0,2,0,0,2,2,2,2],
    [2,0,0,0,0,0,2,0,0,2,0,0,0,0,0,0,2,0,0,2,0,0,0,0,0,2],
    [2,0,0,0,0,0,2,0,0,2,0,0,0,0,0,0,2,0,0,2,0,0,0,0,0,2],
    [3,2,2,2,2,2,2,2,2,2,2,2,2,2,2,2,2,2,2,2,2,2,2,2,2,3]
  ]
}
